2222222222222222222222222222222222222222222222222222222222222222
2222222222222222222222222222222222222222222222222222222222222222
2222222222222222222222222222222222222222222222222222222222222222
2222222222222222222222222222222222222222222222222222222222222222
2222222222222222222222222222222222222222222222222222222222222222
2222222222222222222222222222222222222222222222222222222222222222
2222222222222222222222222222222222222222221111111111100000000009
2222222222222222222222222222222222222222221111111111100300000009
2222222222222222222222222222222222222222221111111111100000000009
2222222222222222222222222222222222222222221111111112200000222222
9000222200000000002222220022000022002222001111111112200000222222
9000222200000000002222220022000022002222001111111112200000222222
2200000000222200000000000000000000000000001111111112299999222222
2200000000222200000000000000000000000000001111111112200000222222
9000000000000000000000000000000000000000001111111112200000222222
9000000000000000000000000000000000000000001111111112200000222222
9999222299999999999999999999999900000000301111111112200000222222
9000000000000000000011111111110000000000000000000000000000222222
9000000000000000000011111111110000000000000000000000000000222222
9000000000000000000011111111110000000000000000000000000000222222
2222222200000000000022222222220000000000000000000000000000222222
2222222200000300000022222222220000000000000000000000000000222222
2222222222222200002222222222222222222222222222111111111111222222
2222222222222200002222222222222222222222222222111111111111222222
2222222222222200002222222222222222222222222222222222222222222222
2222222222222200002222222222222222222222222222222222222222222222
2222222222222200002222222222222222222222222222222222222222222222
2222222222222200002222222222222222222222222222222222222222222222
2222222222222299992222222222222222222222222222222222222222222222