22222222222222299222222222222222222222
22222222220222200222222222222222222222
22222222220000000002222222222222222222
22222222222200000002222222222222222222
22222222222200000002222222222222222222
22222222222200000002222222222222222222
22222222222200000002222222222222222222
22222222222200000002222222222222222222
22221111110000000000111111000000002222
22221111110000000000111111000000002222
22220111110000000000111111000000002222
22221111110000000000111111000000002222
22221111110000022222222111000000002222
22222222220000022222222000000000002222
22222222229999922222222999999000112222
22222222000000022222222111111111112222
22222222000000022222222111111111112222
22220000000000000002222111111111112222
22220000000000000002222111111111112222
22220000000000000002222111111111112222
22220000000000000002222111111111112222
22220000000000000002222111111111112222
22220000220000000002222001111111112222
22220000220000000000000001111111112222
22221111220000000000000000011111112222
22221111220000000000000000000011222222
22221111220000000000000000000000222222
22221111220000022222222000000000222222
22221111229999922222222999999999222222
22221111110000001111110000000000222222
22221111110000001111110000000000222222
22221111110000001111110000000000222222
22221111110000001111110000000000222222
22222222222222222222220000000000222222
22222222222222222222220000000000222222
22222222222222222222222222000000222222
22222222222222222222222222999999222222