222222222220099990022222222222
222222222220000000022222222222
222222222220000000022222222222
222222222220000000022222222222
222220000000000000000000022222
222220000000000000000000022222
222220000000000000000000022222
222220000000000000000000022222
222220022222000000000000022222
222220022222000000222200022222
222220022222200000222200022222
222220022222200000222200022222
222220000000000000000000022222
222220000000000200000000022222
222220000000000000000000022222
222220000000000000000000022222
222220000000000000000000022222
222220000000000000000000022222
222220000000000000222220022222
222220002222000000222220022222
222220002222000002222220022222
222220002222000002222220022222
222220000000000000000000022222
222220000000000000000000022222
222220000000000000000000022222
222220000000000000000000022222
222220000000000000000000022222
222222222222222222222222222222
222222222222222222222222222222
222222222222222222222222222222